##########
#S#      #
# # #### #
# #    # #
# #### # #
#      #E#
##########