##########
#S       #
# ###### #
# #    # #
# # ## # #
#   #    #
### # ####
#   #    #
# ###### #
#       E#
##########
