###########
#S        #
# ####### #
# #     # #
# # ### # #
# # # # # #
# # ### # #
# #     # #
# ####### #
#        E#
###########
