###########
#    S    #
#         #
#         #
#         #
# ####### #
#         #
#         #
#         #
#    E    #
###########
