###########
#S        #
#   ###   #
#   ###   #
#   ###   #
#         #
#   ###   #
#   ###   #
#        E#
###########
