###########
#S        #
# ####### #
# #     # #
# # ### # #
#   # #   #
### # # ###
#   # #   #
# ### ### #
#        E#
###########
