###########
#S#       #
# # ##### #
# # #     #
# # # #####
#   #     #
### ##### #
#   #   # #
# ### # # #
#     #  E#
###########
