###########
#S#       #
# # ##### #
# #     # #
# ##### # #
#     # # #
# ### # # #
# #   #   #
# # ##### #
#        E#
###########
