###########
#S#       #
# # ##### #
# #     # #
# ##### # #
#       # #
# ####### #
#     #   #
##### # # #
#       #E#
###########
