###########
#S        #
#         #
#         #
#   ###   #
#   ###   #
#   ###   #
#         #
#         #
#        E#
###########
