###########
#         #
#    #    #
#    #    #
#    #    #
#E   #   S#
#    #    #
#    #    #
#    #    #
#    #    #
###########
