###########
#S#       #
# # ##### #
# # #   # #
# # # # # #
# # #E# # #
# # ### # #
# #     # #
# ####### #
#         #
###########