###########
#S        #
# ####### #
# #     # #
# # ### # #
# # #E# # #
# # ### # #
# #     # #
# ####### #
#         #
###########
