###########
#S#     # #
# # ### # #
# #   # # #
# ### # # #
#   # #   #
# # # ### #
# # #   # #
# # ### # #
#  E#     #
###########
