###########
#S#       #
# # ##### #
# #     # #
# ### # # #
#     #   #
######### #
#         #
# ### #####
#        E#
###########
