###############
#S#           #
# # ######### #
# #         # #
# ######### # #
#         # # #
# ####### # # #
# #     # #   #
# # ### # #####
# # #   #     #
# # # ####### #
# # #       # #
# # ####### # #
#          E# #
###############
