###############
#S#       #   #
# # ##### # # #
# #     # # # #
# ##### # # # #
#     # # # # #
# ### # # # # #
# #   # #   # #
# # ### ##### #
# # #       # #
# # ####### # #
# #       # # #
# ####### # # #
#  E#       # #
###############
