###############
#S#           #
# # ######### #
# #         # #
# ######### # #
#           # #
####### ##### #
#       #     #
# ####### #####
#       #     #
####### ##### #
#       #   # #
# ####### # # #
#         #  E#
###############
