###############
#      S      #
#             #
#             #
#             #
#             #
# #############
#             #
#             #
#             #
#             #
#             #
#             #
#      E      #
###############
