###############
#S#           #
# # ######### #
# # #       # #
# # # ##### # #
# # # #   # # #
# # # # # # # #
# # # #E# # # #
# # # ### # # #
# # #     # # #
# # ####### # #
# #         # #
# ########### #
#             #
###############
