###############
#             #
#      #      #
#      #      #
#      #      #
#      #      #
#      #      #
#E     #     S#
#      #      #
#      #      #
#      #      #
#      #      #
#      #      #
#             #
###############
