###############
#S            #
# ########### #
# #         # #
# # ####### # #
# # #     # # #
# # # ### # # #
# # # #E# # # #
# # # ### # # #
# # #     # # #
# # ####### # #
# #         # #
# ########### #
#             #
###############
