#####
#S  #
#   #
#  E#
#####
