#####
#S# #
# # #
#  E#
#####
