#####
#S#E#
# # #
#   #
#####
