#######
#S#   #
# # # #
#   # #
# ### #
#    E#
#######
