#######
#S#   #
# # # #
#   # #
### # #
#  E# #
#######
