#######
#S#   #
# # ###
# #   #
# # # #
#   #E#
#######
